Country,Confirmed,Deaths,Recovered,Active,New Cases,Deaths / 100 Cases,Recovered / 100 Cases,Deaths / 100 Recovered,Population,Cases / Million People,Confirmed last week,1 week change,1 week % increase
Afghanistan,208627,7896,0,200731,6,3.78,0.0,0.0,38928341,5359.0,208435,192,0.09
Albania,334211,3596,0,330615,7,1.08,0.0,0.0,2877800,116134.0,334157,54,0.02
Algeria,271394,6881,0,264513,0,2.54,0.0,0.0,43851043,6189.0,271376,18,0.01
Andorra,47850,165,0,47685,0,0.34,0.0,0.0,77265,619297.0,47839,11,0.02
Angola,105184,1931,0,103253,0,1.84,0.0,0.0,32866268,3200.0,105184,0,0.0
Antarctica,11,0,0,11,0,0.0,0.0,0.0,0,154168.1581632653,11,0,0.0
Antigua and Barbuda,9106,146,0,8960,0,1.6,0.0,0.0,97928,92987.0,9106,0,0.0
Argentina,10037135,130421,0,9906714,0,1.3,0.0,0.0,45195777,222081.0,10032709,4426,0.04
Armenia,446008,8717,0,437291,0,1.95,0.0,0.0,2963234,150514.0,446008,0,0.0
Australia,11312904,18828,0,11294076,0,0.17,0.0,0.0,50919400,222173.0,11295446,17458,0.15
Austria,5801078,21755,0,5779323,2841,0.38,0.0,0.0,9006400,644106.0,5774678,26400,0.46
Azerbaijan,828082,10096,0,817986,18,1.22,0.0,0.0,10139175,81672.0,827903,179,0.02
Bahamas,37491,833,0,36658,0,2.22,0.0,0.0,393248,95337.0,37491,0,0.0
Bahrain,700835,1544,0,699291,0,0.22,0.0,0.0,1701583,411872.0,700452,383,0.05
Bangladesh,2037588,29443,0,2008145,0,1.44,0.0,0.0,164689383,12372.0,2037506,82,0.0
Barbados,106157,571,0,105586,0,0.54,0.0,0.0,287371,369407.0,106157,0,0.0
Belarus,994037,7118,0,986919,0,0.72,0.0,0.0,9449321,105197.0,994037,0,0.0
Belgium,4695403,33582,0,4661821,0,0.72,0.0,0.0,22985282,204279.0,4691499,3904,0.08
Belize,70660,688,0,69972,0,0.97,0.0,0.0,397621,177707.0,70610,50,0.07
Benin,27989,163,0,27826,0,0.58,0.0,0.0,12123198,2309.0,27989,0,0.0
Bhutan,62605,21,0,62584,0,0.03,0.0,0.0,771612,81135.0,62598,7,0.01
Bolivia,1189673,22353,0,1167320,0,1.88,0.0,0.0,11673029,101916.0,1187482,2191,0.18
Bosnia and Herzegovina,401412,16259,0,385153,0,4.05,0.0,0.0,3280815,122351.0,401354,58,0.01
Botswana,329227,2800,0,326427,0,0.85,0.0,0.0,2351625,140000.0,328887,340,0.1
Brazil,36867401,697365,0,36170036,0,1.89,0.0,0.0,422706534,87217.0,36794261,73140,0.2
Brunei,276067,225,0,275842,0,0.08,0.0,0.0,437483,631035.0,275220,847,0.31
Bulgaria,1295597,38184,0,1257413,12,2.95,0.0,0.0,6948445,186459.0,1295275,322,0.02
Burkina Faso,22025,396,0,21629,0,1.8,0.0,0.0,20903278,1054.0,22025,0,0.0
Burma,633842,19490,0,614352,2,3.07,0.0,0.0,54409800,11649.0,633819,23,0.0
Burundi,53492,38,0,53454,0,0.07,0.0,0.0,11890781,4499.0,52429,1063,2.03
Cabo Verde,63229,413,0,62816,0,0.65,0.0,0.0,555988,113724.0,63227,2,0.0
Cambodia,138698,3056,0,135642,1,2.2,0.0,0.0,16718971,8296.0,138689,9,0.01
Cameroon,123993,1965,0,122028,0,1.58,0.0,0.0,26545864,4671.0,123993,0,0.0
Canada,4570310,50704,0,4519606,0,1.11,0.0,0.0,76492216,59749.0,4561808,8502,0.19
Central African Republic,15368,113,0,15255,0,0.74,0.0,0.0,4829764,3182.0,15361,7,0.05
Chad,7652,194,0,7458,0,2.54,0.0,0.0,16425859,466.0,7652,0,0.0
Chile,5128130,63895,0,5064235,1473,1.25,0.0,0.0,36692988,139758.0,5116768,11362,0.22
China,4903507,100922,0,4802585,0,2.06,0.0,0.0,2829703778,1733.0,4903495,12,0.0
Colombia,6355135,142244,0,6212891,0,2.24,0.0,0.0,99141018,64102.0,6352923,2212,0.03
Comoros,8992,161,0,8831,0,1.79,0.0,0.0,869595,10340.0,8992,0,0.0
Congo (Brazzaville),25375,388,0,24987,0,1.53,0.0,0.0,89561403,283.0,25375,0,0.0
Congo (Kinshasa),95514,1463,0,94051,0,1.53,0.0,0.0,5518087,17309.0,95473,41,0.04
Costa Rica,1186176,9158,0,1177018,0,0.77,0.0,0.0,5094114,232852.0,1182371,3805,0.32
Cote d'Ivoire,87997,833,0,87164,0,0.95,0.0,0.0,26378274,3336.0,87981,16,0.02
Croatia,1267894,17895,0,1249999,44,1.41,0.0,0.0,4105268,308846.0,1267511,383,0.03
Cuba,1112484,8530,0,1103954,11,0.77,0.0,0.0,11326616,98219.0,1112422,62,0.01
Cyprus,644160,1291,0,642869,0,0.2,0.0,0.0,1207361,533527.0,642663,1497,0.23
Czechia,4591500,42326,0,4549174,91,0.92,0.0,0.0,10708981,428752.0,4588772,2728,0.06
Denmark,3446909,8214,0,3438695,0,0.24,0.0,0.0,5942850,580009.0,3445821,1088,0.03
Diamond Princess,712,13,0,699,0,1.83,0.0,0.0,0,154168.1581632653,712,0,0.0
Djibouti,15690,189,0,15501,0,1.2,0.0,0.0,988002,15881.0,15690,0,0.0
Dominica,15760,74,0,15686,0,0.47,0.0,0.0,71991,218916.0,15760,0,0.0
Dominican Republic,660095,4384,0,655711,0,0.66,0.0,0.0,10847904,60850.0,660095,0,0.0
Ecuador,1052007,35942,0,1016065,0,3.42,0.0,0.0,17643060,59627.0,1051239,768,0.07
Egypt,515645,24806,0,490839,0,4.81,0.0,0.0,102334403,5039.0,515645,0,0.0
El Salvador,201785,4230,0,197555,0,2.1,0.0,0.0,6486201,31110.0,201785,0,0.0
Equatorial Guinea,17190,183,0,17007,0,1.06,0.0,0.0,1402985,12252.0,17186,4,0.02
Eritrea,10189,103,0,10086,0,1.01,0.0,0.0,3546427,2873.0,10189,0,0.0
Estonia,613903,2912,0,610991,0,0.47,0.0,0.0,1326539,462785.0,613531,372,0.06
Eswatini,74143,1423,0,72720,10,1.92,0.0,0.0,1160164,63907.0,74133,10,0.01
Ethiopia,499656,7572,0,492084,13,1.52,0.0,0.0,114963583,4346.0,499466,190,0.04
Fiji,68848,883,0,67965,0,1.28,0.0,0.0,896444,76801.0,68820,28,0.04
Finland,1459198,8739,0,1450459,0,0.6,0.0,0.0,5540718,263359.0,1458619,579,0.04
France,39741331,165407,0,39575924,0,0.42,0.0,0.0,68128061,583333.0,39713004,28327,0.07
Gabon,48981,306,0,48675,0,0.62,0.0,0.0,2225728,22007.0,48980,1,0.0
Gambia,12586,372,0,12214,0,2.96,0.0,0.0,2416664,5208.0,12586,0,0.0
Georgia,1815871,16934,0,1798937,0,0.93,0.0,0.0,3989175,455200.0,1814180,1691,0.09
Germany,37822577,166128,0,37656449,0,0.44,0.0,0.0,166310062,227422.0,37739472,83105,0.22
Ghana,171112,1462,0,169650,0,0.85,0.0,0.0,31072945,5507.0,171112,0,0.0
Greece,5548487,34779,0,5513708,0,0.63,0.0,0.0,10423056,532328.0,5548487,0,0.0
Grenada,19680,238,0,19442,0,1.21,0.0,0.0,112519,174904.0,19680,0,0.0
Guatemala,1229596,20128,0,1209468,36,1.64,0.0,0.0,17915567,68633.0,1227024,2572,0.21
Guinea,38240,467,0,37773,0,1.22,0.0,0.0,13132792,2912.0,38240,0,0.0
Guinea-Bissau,8947,176,0,8771,0,1.97,0.0,0.0,1967998,4546.0,8947,0,0.0
Guyana,72984,1295,0,71689,0,1.77,0.0,0.0,786559,92789.0,72922,62,0.09
Haiti,34076,860,0,33216,0,2.52,0.0,0.0,11402533,2988.0,34008,68,0.2
Holy See,29,0,0,29,0,0.0,0.0,0.0,809,35847.0,29,0,0.0
Honduras,470940,11104,0,459836,0,2.36,0.0,0.0,9904608,47548.0,470337,603,0.13
Hungary,2192448,48677,0,2143771,0,2.22,0.0,0.0,9660350,226953.0,2191827,621,0.03
Iceland,208688,199,0,208489,0,0.1,0.0,0.0,341250,611540.0,208605,83,0.04
India,44684679,530745,0,44153934,91,1.19,0.0,0.0,2751341248,16241.0,44683943,736,0.0
Indonesia,6731135,160832,0,6570303,171,2.39,0.0,0.0,273523621,24609.0,6729573,1562,0.02
Iran,7564756,144757,0,7419999,93,1.91,0.0,0.0,83992953,90064.0,7564146,610,0.01
Iraq,2465545,25375,0,2440170,0,1.03,0.0,0.0,40222503,61298.0,2465545,0,0.0
Ireland,1700817,8515,0,1692302,0,0.5,0.0,0.0,4937796,344449.0,1700253,564,0.03
Israel,4788399,12215,0,4776184,326,0.26,0.0,0.0,8655541,553218.0,4784702,3697,0.08
Italy,25488166,187272,0,25300894,0,0.73,0.0,0.0,120822834,210955.0,25453789,34377,0.14
Jamaica,153629,3484,0,150145,0,2.27,0.0,0.0,2961161,51881.0,153407,222,0.14
Japan,32766847,69485,0,32697362,32459,0.21,0.0,0.0,252643406,129696.0,32486503,280344,0.86
Jordan,1746997,14122,0,1732875,0,0.81,0.0,0.0,10203140,171222.0,1746997,0,0.0
Kazakhstan,1496549,19065,0,1477484,0,1.27,0.0,0.0,18776707,79702.0,1496390,159,0.01
Kenya,342817,5688,0,337129,0,1.66,0.0,0.0,53771300,6375.0,342810,7,0.0
Kiribati,5008,18,0,4990,0,0.36,0.0,0.0,117606,42583.0,4991,17,0.34
"Korea, North",1,6,0,-5,0,600.0,0.0,0.0,25778815,0.0,1,0,0.0
"Korea, South",30263261,33614,0,30229647,5850,0.11,0.0,0.0,51269183,590282.0,30157017,106244,0.35
Kosovo,272621,3204,0,269417,13,1.18,0.0,0.0,1793000,152047.0,272537,84,0.03
Kuwait,662858,2570,0,660288,0,0.39,0.0,0.0,4270563,155216.0,662858,0,0.0
Kyrgyzstan,206592,2991,0,203601,0,1.45,0.0,0.0,6524191,31666.0,206591,1,0.0
Laos,217990,758,0,217232,3,0.35,0.0,0.0,7275556,29962.0,217962,28,0.01
Latvia,975403,6239,0,969164,0,0.64,0.0,0.0,1886202,517125.0,975230,173,0.02
Lebanon,1229390,10795,0,1218595,0,0.88,0.0,0.0,6825442,180119.0,1228399,991,0.08
Lesotho,34790,723,0,34067,0,2.08,0.0,0.0,2142252,16240.0,34790,0,0.0
Liberia,8062,294,0,7768,0,3.65,0.0,0.0,5057677,1594.0,8053,9,0.11
Libya,507162,6437,0,500725,0,1.27,0.0,0.0,6871287,73809.0,507159,3,0.0
Liechtenstein,21359,89,0,21270,0,0.42,0.0,0.0,38137,560060.0,21349,10,0.05
Lithuania,1297880,9550,0,1288330,42,0.74,0.0,0.0,2722291,476760.0,1295930,1950,0.15
Luxembourg,314882,1211,0,313671,0,0.38,0.0,0.0,625976,503026.0,314607,275,0.09
MS Zaandam,9,2,0,7,0,22.22,0.0,0.0,0,154168.1581632653,9,0,0.0
Madagascar,67842,1420,0,66422,15,2.09,0.0,0.0,27691019,2450.0,67827,15,0.02
Malawi,88559,2686,0,85873,0,3.03,0.0,0.0,19129955,4629.0,88505,54,0.06
Malaysia,5037995,36943,0,5001052,211,0.73,0.0,0.0,64998698,77509.0,5036140,1855,0.04
Maldives,185715,311,0,185404,0,0.17,0.0,0.0,540542,343572.0,185713,2,0.0
Mali,32790,743,0,32047,0,2.27,0.0,0.0,20250834,1619.0,32780,10,0.03
Malta,117062,824,0,116238,0,0.7,0.0,0.0,441539,265123.0,116953,109,0.09
Marshall Islands,15584,17,0,15567,0,0.11,0.0,0.0,58413,266790.0,15554,30,0.19
Mauritania,63665,997,0,62668,0,1.57,0.0,0.0,4649660,13692.0,63664,1,0.0
Mauritius,294602,1043,0,293559,0,0.35,0.0,0.0,1271767,231648.0,294602,0,0.0
Mexico,7389670,332475,0,7057195,8365,4.5,0.0,0.0,255584572,28913.0,7367712,21958,0.3
Micronesia,22676,58,0,22618,0,0.26,0.0,0.0,113815,199236.0,22676,0,0.0
Moldova,598673,11953,0,586720,0,2.0,0.0,0.0,8055380,74320.0,598073,600,0.1
Monaco,16069,65,0,16004,0,0.4,0.0,0.0,39244,409464.0,16056,13,0.08
Mongolia,1007874,2136,0,1005738,0,0.21,0.0,0.0,3278292,307439.0,1007865,9,0.0
Montenegro,286493,2797,0,283696,0,0.98,0.0,0.0,628062,456154.0,286235,258,0.09
Morocco,1272280,16296,0,1255984,4,1.28,0.0,0.0,36910558,34469.0,1272229,51,0.0
Mozambique,231994,2233,0,229761,0,0.96,0.0,0.0,31255435,7423.0,231994,0,0.0
Namibia,170741,4088,0,166653,0,2.39,0.0,0.0,2540916,67197.0,170496,245,0.14
Nauru,4621,1,0,4620,0,0.02,0.0,0.0,10834,426528.0,4621,0,0.0
Nepal,1001106,12020,0,989086,0,1.2,0.0,0.0,29136808,34359.0,1001096,10,0.0
Netherlands,8696317,23704,0,8672613,0,0.27,0.0,0.0,34882427,249304.0,8694054,2263,0.03
New Zealand,2190121,2479,0,2187642,0,0.11,0.0,0.0,4841342,452379.0,2190095,26,0.0
Nicaragua,15592,245,0,15347,0,1.57,0.0,0.0,6624554,2354.0,15569,23,0.15
Niger,9508,315,0,9193,0,3.31,0.0,0.0,24206636,393.0,9508,0,0.0
Nigeria,266463,3155,0,263308,0,1.18,0.0,0.0,399640130,667.0,266463,0,0.0
North Macedonia,346533,9641,0,336892,0,2.78,0.0,0.0,2083380,166332.0,346428,105,0.03
Norway,1478042,5137,0,1472905,17,0.35,0.0,0.0,5421242,272639.0,1477737,305,0.02
Oman,399449,4628,0,394821,0,1.16,0.0,0.0,5106622,78222.0,399154,295,0.07
Pakistan,1576397,30640,0,1545757,54,1.94,0.0,0.0,428724125,3677.0,1576235,162,0.01
Palau,5986,9,0,5977,0,0.15,0.0,0.0,18008,332408.0,5986,0,0.0
Panama,1029701,8596,0,1021105,0,0.83,0.0,0.0,4314768,238646.0,1029061,640,0.06
Papua New Guinea,46750,670,0,46080,0,1.43,0.0,0.0,8947027,5225.0,46663,87,0.19
Paraguay,806662,19830,0,786832,0,2.46,0.0,0.0,7132530,113096.0,806256,406,0.05
Peru,4482582,219195,0,4263387,85,4.89,0.0,0.0,65597846,68334.0,4481246,1336,0.03
Philippines,4073826,65851,0,4007975,87,1.62,0.0,0.0,109581085,37176.0,4072911,915,0.02
Poland,6383096,118748,0,6264348,121,1.86,0.0,0.0,76257753,83704.0,6378349,4747,0.07
Portugal,5564254,26033,0,5538221,0,0.47,0.0,0.0,10196707,545691.0,5563265,989,0.02
Qatar,492647,686,0,491961,52,0.14,0.0,0.0,2881060,170995.0,492283,364,0.07
Romania,3325006,67576,0,3257430,0,2.03,0.0,0.0,38837451,85613.0,3322648,2358,0.07
Russia,21687216,387324,0,21299892,9355,1.79,0.0,0.0,292579178,74124.0,21629273,57943,0.27
Rwanda,133090,1468,0,131622,0,1.1,0.0,0.0,12952209,10275.0,133090,0,0.0
Saint Kitts and Nevis,6592,46,0,6546,0,0.7,0.0,0.0,53109,124122.0,6591,1,0.02
Saint Lucia,29803,409,0,29394,0,1.37,0.0,0.0,183629,162300.0,29803,0,0.0
Saint Vincent and the Grenadines,9585,123,0,9462,0,1.28,0.0,0.0,110854,86465.0,9581,4,0.04
Samoa,16087,29,0,16058,0,0.18,0.0,0.0,196130,82022.0,16022,65,0.41
San Marino,23427,122,0,23305,0,0.52,0.0,0.0,33938,690288.0,23403,24,0.1
Sao Tome and Principe,6280,77,0,6203,0,1.23,0.0,0.0,219159,28655.0,6279,1,0.02
Saudi Arabia,828171,9580,0,818591,40,1.16,0.0,0.0,34813867,23789.0,827861,310,0.04
Senegal,88902,1971,0,86931,0,2.22,0.0,0.0,16743930,5310.0,88900,2,0.0
Serbia,2474636,17721,0,2456915,441,0.72,0.0,0.0,8737370,283224.0,2471072,3564,0.14
Seychelles,50665,172,0,50493,0,0.34,0.0,0.0,98340,515202.0,50355,310,0.62
Sierra Leone,7760,126,0,7634,0,1.62,0.0,0.0,7976985,973.0,7760,0,0.0
Singapore,2219180,1722,0,2217458,299,0.08,0.0,0.0,5850343,379325.0,2216185,2995,0.14
Slovakia,2661315,20961,0,2640354,31,0.79,0.0,0.0,10823892,245874.0,2660507,808,0.03
Slovenia,1322543,7060,0,1315483,50,0.53,0.0,0.0,2078932,636165.0,1321147,1396,0.11
Solomon Islands,24575,153,0,24422,0,0.62,0.0,0.0,652858,37642.0,24575,0,0.0
Somalia,27318,1361,0,25957,0,4.98,0.0,0.0,15893219,1719.0,27318,0,0.0
South Africa,4056701,102595,0,3954106,0,2.53,0.0,0.0,59308690,68400.0,4055416,1285,0.03
South Sudan,18368,138,0,18230,0,0.75,0.0,0.0,11193729,1641.0,18368,0,0.0
Spain,13740531,118712,0,13621819,0,0.86,0.0,0.0,93691843,146657.0,13731478,9053,0.07
Sri Lanka,672000,16828,0,655172,0,2.5,0.0,0.0,21413250,31382.0,671987,13,0.0
Sudan,63754,5008,0,58746,0,7.86,0.0,0.0,43849269,1454.0,63736,18,0.03
Summer Olympics 2020,865,0,0,865,0,0.0,0.0,0.0,0,154168.1581632653,865,0,0.0
Suriname,82227,1400,0,80827,0,1.7,0.0,0.0,586634,140167.0,82020,207,0.25
Sweden,2694893,23448,0,2671445,0,0.87,0.0,0.0,20426859,131929.0,2693458,1435,0.05
Switzerland,4407915,14244,0,4393671,0,0.32,0.0,0.0,8654618,509314.0,4406243,1672,0.04
Syria,57453,3164,0,54289,0,5.51,0.0,0.0,17500657,3283.0,57453,0,0.0
Taiwan*,9668845,16687,0,9652158,22983,0.17,0.0,0.0,23806638,406141.0,9483267,185578,1.96
Tajikistan,17786,125,0,17661,0,0.7,0.0,0.0,9537642,1865.0,17786,0,0.0
Tanzania,42664,846,0,41818,0,1.98,0.0,0.0,59734213,714.0,42600,64,0.15
Thailand,4727236,33882,0,4693354,252,0.72,0.0,0.0,69799978,67725.0,4726984,252,0.01
Timor-Leste,23415,138,0,23277,0,0.59,0.0,0.0,1318442,17760.0,23414,1,0.0
Togo,39356,290,0,39066,1,0.74,0.0,0.0,8278737,4754.0,39354,2,0.01
Tonga,16779,13,0,16766,0,0.08,0.0,0.0,105697,158746.0,16734,45,0.27
Trinidad and Tobago,187908,4326,0,183582,0,2.3,0.0,0.0,1399491,134269.0,187585,323,0.17
Tunisia,1150356,29308,0,1121048,0,2.55,0.0,0.0,11818618,97334.0,1150278,78,0.01
Turkey,17042722,101492,0,16941230,0,0.6,0.0,0.0,84339067,202074.0,17042722,0,0.0
Tuvalu,2805,0,0,2805,0,0.0,0.0,0.0,11792,237873.0,2805,0,0.0
US,102592195,1111495,0,101480700,1994,1.08,0.0,0.0,330541757,310376.0,102274714,317481,0.31
Uganda,170400,3630,0,166770,0,2.13,0.0,0.0,45741000,3725.0,170328,72,0.04
Ukraine,5682632,119018,0,5563614,55,2.09,0.0,0.0,89634808,63398.0,5679279,3353,0.06
United Arab Emirates,1049828,2348,0,1047480,99,0.22,0.0,0.0,9890400,106146.0,1049274,554,0.05
United Kingdom,24526807,217658,0,24309149,0,0.89,0.0,0.0,135034386,181634.0,24507298,19509,0.08
Uruguay,1032710,7609,0,1025101,0,0.74,0.0,0.0,3473727,297292.0,1031581,1129,0.11
Uzbekistan,250622,1637,0,248985,0,0.65,0.0,0.0,33469199,7488.0,250508,114,0.05
Vanuatu,12014,14,0,12000,0,0.12,0.0,0.0,292680,41048.0,12014,0,0.0
Venezuela,551645,5849,0,545796,26,1.06,0.0,0.0,28435943,19400.0,551412,233,0.04
Vietnam,11526566,43186,0,11483380,7,0.37,0.0,0.0,97338583,118417.0,11526408,158,0.0
West Bank and Gaza,703228,5708,0,697520,0,0.81,0.0,0.0,4543126,154789.0,703228,0,0.0
Winter Olympics 2022,535,0,0,535,0,0.0,0.0,0.0,0,154168.1581632653,535,0,0.0
Yemen,11945,2159,0,9786,0,18.07,0.0,0.0,29825968,400.0,11945,0,0.0
Zambia,341573,4049,0,337524,0,1.19,0.0,0.0,18383956,18580.0,340172,1401,0.41
Zimbabwe,262324,5658,0,256666,0,2.16,0.0,0.0,14862927,17650.0,261606,718,0.27
